w0 w0 w0 w0 w0 w0 w0 w0 w0 w0 w0 w0 w0 w0 w0 w0 w0
w0 .0 .0 .0 .0 .0 .0 .0 .0 .0 .0 .0 .0 .0 .0 .0 w0
w0 .0 .0 .0 .0 .0 .0 .0 .0 .0 .0 .0 .0 .0 .0 .0 w0
w0 .0 .0 .0 .0 .0 .0 .0 .0 .0 .0 .0 .0 .0 .0 .0 w0
w0 .0 .0 .0 .0 .0 .0 .0 .0 .0 .0 .0 .0 .0 .0 .0 w0
w0 .0 .0 .0 .0 .0 .0 >2 .0 .0 .0 v2 .0 .0 .0 .0 w0
w0 .0 .0 .0 .0 .0 .0 .0 .0 .0 .0 .0 .0 .0 .0 .0 w0
w0 .0 .0 .0 .0 .0 .0 .0 .0 .0 .0 .0 .0 .0 .0 .0 w0
w0 .0 .0 .0 .0 .0 .0 .0 .0 .0 .0 .0 .0 .0 .0 .0 w0
w0 .0 .0 .0 .0 .0 .0 .0 .0 .0 .0 .0 .0 .0 .0 .0 w0
w0 .0 .0 .0 .0 .0 .0 s0 .0 .0 .0 .0 .0 .0 .0 .0 w0
w0 .0 .0 .0 .0 .0 .0 .0 .0 .0 .0 .0 .0 .0 .0 .0 w0
w0 .0 .0 .0 ^2 .0 .0 .0 .0 .0 .0 <2 .0 .0 .0 .0 w0
w0 w0 w0 w0 w0 w0 w0 w0 w0 w0 w0 w0 w0 w0 w0 w0 w0

redbots=99
orangebots=99
yellowbots=99
greenbots=99
bluebots=99
purplebots=99
whitebots=99
redwalls=99
orangewalls=99
yellowwalls=99
greenwalls=99
bluewalls=99
purplewalls=99
graywalls=99